                                         




NO                                      ./textures/north_texture.xpm

C                                     040,5,5


                                                                       

EA                                    ./textures/east_texture.xpm
                                                                                                                            
WE                                   ./textures/west_texture.xpm
                                                                                             
SO                                      ./textures/south_texture.xpm
                                                                                             

F   10, 9 ,00002

        1111111111111111111111111
        1000000000110000000000001
        1011000001110000000000001
        1001000000000000000000001
111111111011000001110000000000001
1000000000110000011101110001111111
11110111111111011100000010001
11110111111111011101010010001
1100000011010101110000010001
10000000000000001100000010001
10000000000000001101010010001
11000001110101011111011110N0111
11110111 1110101 101111010001
11111111 1111111 111111111111